-72 -70 -73 -71 -73 -69 -70 -72 -71 -73 -70 -70 -70 -71 -73 -72 -72 -71
-74 -73 -72 -71 -70 -70 -69 -69 -68 -69 -69 -70 -69 -69 -69 -68 -69 -70
-70 -73 -71 -70 -66 -74 -68 -70 -71 -71 -67 -72 -69 -72 -71 -72 -68 -73
-69 -70 -71 -69 -71 -70 -67 -67 -73 -69 -69 -69 -70 -70 -70 -71 -69 -72
-68 -72 -69 -68 -70 -70 -69 -65 -71 -69 -66 -67 -69 -68 -68 -68 -71 -71
-69 -70 -72 -68 -71 -69 -69 -62 -68 -69 -69 -70 -66 -65 -66 -68 -70 -67
-71 -69 -69 -68 -69 -67 -65 -59 -58 -66 -68 -63 -62 -67 -70 -70 -72 -68
-73 -69 -72 -70 -69 -68 -63 -59 -58 -61 -63 -60 -63 -63 -66 -69 -68 -71
-70 -70 -68 -67 -66 -62 -63 -59 -55 -53 -65 -68 -64 -67 -69 -69 -71 -73
-74 -74 -70 -67 -65 -63 -64 -61 -54 -42 -59 -61 -66 -68 -65 -69 -68 -66
-69 -72 -72 -69 -67 -68 -59 -63 -56 -49 -57 -57 -63 -65 -67 -64 -71 -68
-71 -68 -71 -70 -69 -62 -61 -54 -59 -52 -52 -60 -62 -65 -70 -69 -71 -69
-70 -72 -69 -69 -66 -63 -61 -59 -59 -54 -54 -57 -61 -65 -64 -65 -69 -66
-73 -70 -64 -65 -63 -65 -60 -61 -57 -56 -57 -54 -63 -64 -68 -67 -68 -67
-69 -70 -69 -69 -67 -66 -65 -64 -56 -51 -56 -58 -60 -64 -64 -63 -68 -69
-69 -70 -66 -68 -72 -66 -67 -65 -61 -54 -59 -58 -60 -64 -66 -64 -65 -70
-72 -69 -70 -71 -69 -67 -70 -68 -57 -59 -61 -58 -61 -60 -68 -63 -68 -69
-70 -68 -72 -70 -64 -67 -67 -63 -64 -58 -59 -55 -58 -64 -63 -66 -68 -67